     R 1020 680     

     NO    txt1.xpm   
    SO txt2.xpm
          WE   txt3.xpm
EA  txt4.xpm
S          covid.xpm

        F 31,133,222
   C 225,30,0
111111
111001
1100N1
111111
