         R 1000 680   

      SO  txt1.xpm  

        C 134, 115   ,47      
     

    WE   txt2.xpm

EA txt3.xpm      

    NO       txt4.xpm
S            covid.xpm


   F 44,  56,66
 
     1
     1
     1
1111111
1100001
1102011111
11000000011111
1111111100001
     1110E001
     10000011
     10102011
     10100011
     11111111
