         R 1000 680   

      SO  ./path_to_the_south_texture   

        F 31, 133   ,222      
     

    WE ./path_to_the_west_texture  

EA ./path_to_the_east_texture      

    NO       ./path_to_the_north_texture
S             ./path_to_the_sprite_texture


   C 225,  30,255 
     1
     1
     1
1111111
1100001
1102011111
11000000011111
1111111100001
     1110S001
     10000011
     10102011
     10100011
     11111111
