         R 1000 680   
        F 31,133    ,0222      
     
SO txt1.xpm
NO txt2.xpm
EA txt3.xpm
WE txt4.xpm
S covid.xpm


   C 225,  30,0 
1111111
1100001
1102011111
111111
     11111111
     10000001
     1110E001
     11111111



11111
11021
11111
