     R 1020 680     
NO txt1.xpm
SO txt2.xpm
WE txt3.xpm
EA txt4.xpm
S covid.xpm

        F 31,133,122
   C 25,130,200
1111111
1100001
1102011111
11000000011111
1111111100001
     1110S001
     10000011
     10102011
     10100011
     11111111
