     R 1020 680     
NO txt1.xpm
SO txt2.xpm
WE txt3.xpm
EA txt4.xpm
S covid.xpm

        F 31,133,122
   C 25,130,200
111111111111111111111111111
110000000000000000000000001
110000111111111111111111101  1111111111111111
1100001                 101111E00202020202021
1100001                 101111012020202020201
1100001                 100000010202020202021
1100001                 111111112020202020201
1100001                 111111110202020202021
11000011111             111111112020202020201 
11000000011111          111111111111111111111
1111111100001
     11100001
     10000011
     10100011
     10100011
     11111111
