         R 1000 	680   




      SO  ./path_to_the_south_texture   



        F 220,100    ,0324      


			WE ./path_to_the_west_texture  

EA ./path_to_the_east_texture      

	    NO       ./path_to_the_north_texture
S             ./path_to_the_sprite_texture


   C 225,  30,0 
111111
100101
102001
1100N1
111111
